NO textures/redbrick.xpm

SO textures/mossy.xpm

WE textures/eagle.xpm

EA textures/bluestone.xpm

F 125,125,125
C 0,50,100

        1111111111111111111111111111
        1000000000110000000000001111111
        1011000001010101010000001111111111
        1001000000000000000000011   11111
111111111011000011010101010000001111111111
1000S0000011000001110111111111111
11110111111111011100000010001
11110111111111011101010010001
11000000110101011100000010001
10000000000000001100000010001
10010010000000001101010010001
1100000111010101111101111000111
11110111 1110101 101111010001
11111111 1111111 11111111111
          1111
