NO textures/Texture0.xpm

SO textures/Texture1.xpm

WE textures/Texture2.xpm

EA textures/Texture3.xpm

F 0,0,125
C 125,125,125

        1111111111111111111111111111
        1000000000110000000000001111111
        1011000001010101010000001111111111
        1001000000000000000000011   11111
111111111011000011010101010000001111111111
100000000011000001110111111111111
11110111111111011100000010001
11110111111111011101010010001
11000000110101011100000010001
10000000000000001100000010001
10010010000000001101010010001
110000W111010101111101111000111
11110111 1110101 101111010001
11111111 1111111 11111111111
          1111

1111111
1000001
1000001
100N001
1000001
1000001
1111111

  1
 101
11011
10001
10S01
10011
10001
10001
10001
10001
10101
10001
 101
 101
  1

111111111111111
10000W000000001
111111111111111


111111111111111111111111
100000000000000000000001
100000000000000000000001
100000000000000000000001
100000000000000000000001
100000000000000000000001
100000000000000000000001
100000000000000000000001
100000000000000000000001
100000000000000000000001
100000000000000000000001
100000000000000000000001
1000000000000000000000S1
100000000000000000000001
100000000000000000000001
100000000000000000000001
100000000000000000000001
100000000000000000000001
100000000000000000000001
100000000000000000000001
100000000000000000000001
100000000000000000000001
100000000000000000000001
111111111111111111111111


111111111111111111111111111111111111111111111111
1S0000000000000000000000000000000000000000000001
100000000000000000000000000000000000000000000001
100000000000000000000100001000000000000000000001
100000000000000000000000010000000000000000000001
100000000000000000000000000000000000000000000001
100000000000000000000000000000000000000000000001
100000000000000000000000000000000000000000000001
100000000000000000000000000000000000000000000001
100000000000000000000000000000000000000000000001
100000000000000000000000000000000000000000000001
100000000000000000000000000000000000000000000001
100000000000000000000000000000000000000000000001
100000000000000000000000000000000000000000000001
100000000000000000000000000000000000000000000001
100000000000000000000000000000000000000000000001
100000000000000000000000000000000000000000000001
100000000000000000000000000000000000000000000001
100000000000000000000000000000000000000000000001
100000000000000000000000000000000000000000000001
100000000000000000000000000000000000000000000001
100000000000000000000000000000000000000000000001
111111111111111111111111111111111111111111111111






 1111111111
100000000001
 1111111111

 1
101
101
101
1N1
101
 1

 1
1N1
 1
