NO textures/Texture0.xpm

SO textures/Texture1.xpm

WE textures/Texture2.xpm

EA textures/Texture3.xpm

F 220,100,0
C 225,30,0

        1111111111111111111111111111
        1000000000110000000000001111111
        1011000001110000000000001111111111
        10010000000000000000000011   11111
111111111011000001110000000000001111111111
100000000011000001110111111111111
11110111111111011100000010001
11110111111111011101010010001
11000000110101011100000010001
10000000000000001100000010001
10000000000000001101010010001
110000011101010111110111100N111
11110111 1110101 101111010001
11111111 1111111 11111111111
          1111


1111111111
100000000001
1111111111

 1
101
101
101
1N1
101
 1

 1
1N1
 1
