NO ./textures/Texture0.png

SO ./textures/Texture1.png

WE ./textures/Texture2.png

EA ./textures/Texture3.png

F 220,100,0
C 225,30,0

        1111111111111111111111111
        1000000000110000000000001
        10110000011100000000000011111111
        100100000000000000000000111111N1
1111111110110000011100000000000011111111
100000000011000001110111111111111
11110111111111011100000010001
11110111111111011101010010001
11000000110101011100000010001
10000000000000001100000010001
10000000000000001101010010001
1100000111010101111101111000111
11110111 1110101 101111010001
11111111 1111111 11111111111
          1


1111111111
100000000001
1111111111

 1
101
101
101
1N1
101
 1

 1
1N1
 1