NO textures/Texture5.xpm
SO textures/Texture6.xpm
WE textures/Texture15.xpm
EA textures/Texture14.xpm

F 100,100,100
C 50,100,150

111111111
1000000W1
111011101
100000001
101111101
100000001
111111111
