NO textures/Texture2.xpm
SO textures/Texture3.xpm
WE textures/Texture4.xpm
EA textures/Texture1.xpm

F 200,200,200
C 25,75,125

111111111111
100000010001
1N11101010111
1000101010001
1110101011101
1000001000001
1011111010111
1000000010001
111111111111
