NO textures/Texture12.xpm
SO textures/Texture13.xpm
WE textures/Texture14.xpm
EA textures/Texture11.xpm

F 150,100,175
C 25,0,150

111111111111111111
1E0000000000100001
1011111110110111101
1000000010000000001
1110111010111110111
1000100000000010001
1011101111011011101
1000001000010000001
1111011011111011111
1000010000000010001
1011111111011110101
1000000000010000001
1110111111011110111
1000000000000000001
1011111011111111101
1000000010000000001
1111111111111111111
